03 03 03 03 03 03 03 03 03 03 03 03
03 00 00 00 00 00 02 00 00 00 00 03
01 01 01 00 00 02 02 00 00 00 00 03
03 00 01 00 00 02 00 00 00 00 00 03
03 00 01 00 02 02 02 00 00 00 00 03
03 00 01 02 02 02 02 02 00 00 00 03
03 00 01 02 02 02 02 02 00 00 00 03
03 00 01 00 00 02 00 00 00 00 00 03
03 00 01 00 02 02 00 00 00 00 00 03
03 00 01 01 01 01 01 01 01 01 00 03
03 00 00 00 02 00 00 00 00 01 00 03
03 03 03 03 03 03 03 03 03 01 03 03
